0000000000
0101101110
0101101110
0000100010
1110111010
1110000010
0000101010
1010111110
0110000000
0000111111
