1100000000
1101111110
1101111110
0000001110
0111111110
0111100000
0000001111
1101101111
1101101111
0001100000
