0000000010
0111111110
0100000000
0001111111
1100011010
1111011010
1110000010
1100111010
1001111010
0011111000
