0000000000
0111111110
0111111110
0111111110
0111111110
0000000000
0111011110
0111011110
0111011110
0000000000
