0000010000
0111010111
0001010111
1101010111
1101000011
1101011011
1101111000
0000000010
0111110110
0111100010
