0000100000
0010101111
0010100001
0010100001
0010110001
0010001001
0011100001
0000101001
0000100000
0000000000
