0010000000
0110111110
0110100110
0110110000
0110001110
0111101110
0111000000
0000010111
1110110110
0000110000
