0000000010
0101110000
0100010111
0111010110
0000010110
0111010100
0111010101
0101010101
0101000000
0000011111
