0000001110
0111100110
0001110110
1001110110
0010110110
0110000000
0010110110
1000010110
1111010110
0000010000
