11111000001
11111011101
11111011101
00000000001
11101111101
11101111101
11101111101
11101111101
00000000001
00000000001

